#######
S   # #
# # # #
# #   #
### # #
#   # E
#######