█████████████████████████████████████████████████████████████████████████████████
S           █       █   █     █         █     █   █ █   █             █         █
███ █ █████ ███████ █ █ █ █ ███ ███ ███████ █ █ ███ █ █ █ █ █ █ ███████████ █ ███
█ █ █ █ █ █ █     █ █ █   █   █ █           █   █     █ █ █ █ █ █ █     █   █   █
█ ███ █ █ ███ █ █ █ ███ █████ ███ █ █ █ █ ███ █ ███████ █ ███ ███ ███ █ █████ ███
█   █         █ █   █ █     █     █ █ █ █ █   █ █       █ █ █     █   █ █     █ █
█ ███████ █ ███ █████ ███ █████████ █ █ █ ███ █ ███ ███ ███ █ █ ███ ███ █ █ ███ █
█     █   █   █ █ █   █   █     █   █ █ █ █ █ █ █     █     █ █ █   █   █ █ █   █
█ █████ ███ ███ █ █ ███████ ███ ███ ███ █ █ █ ███████ █████ █ █████ ███ █ ███ ███
█   █ █   █   █ █   █     █   █ █   █   █ █ █   █ █     █           █   █     █ █
█ ███ █ ███████ █ █████ █ █ ███ ███████ █ █ █████ ███ █ ███████████ █████████ █ █
█     █ █     █   █ █   █ █   █ █       █ █   █ █ █ █ █   █ █ █ █     █ █   █   █
█ ███ █ █████ █ ███ █ █████ ███████ ███████ █ █ █ █ ███ █ █ █ █ █ █ ███ █ █ ███ █
█ █   █ █     █             █ █ █ █ █   █   █ █     █ █ █     █   █       █     █
█ █ █████ █ █ ███████ ███ █ █ █ █ █ ███ █████ █ █ ███ █ ███ █ █ █ █ ███████ ███ █
█ █   █ █ █ █         █   █     █ █ █     █ █   █   █     █ █ █ █ █ █ █       █ █
███ ███ ███ █ █ ███████████ █████ █ █ █████ █ ███ █ █ █ █ █████ █ ███ ███ ███████
█   █   █   █ █     █     █ █   █       █     █ █ █ █ █ █ █ █   █ █   █     █   █
███ █ ███ ███ ███ █████ █████ █ ███ █████ ███ █ █ █████ ███ ███████ █████ ███ ███
█           █ █ █     █   █   █   █         █   █ █             █   █       █ █ █
█ █████ ███ ███ █ █████ ███ ███ ███████ █ █ ███████ ███ ███ ███ ███ █ █ █ ███ █ █
█   █     █ █ █               █       █ █ █ █     █ █ █   █ █       █ █ █   █   █
███ ███████ █ ███████ █ █ █ █ ███ █ █ ███ █████ ███ █ ███████████████████ █ █ ███
█   █     █   █       █ █ █ █   █ █ █   █   █   █           █       █     █ █   █
███ █ █ ███████ █ █████████ ███ ███ █ ███ ███ ███ █ █ ███ █ █ █████████ █████ ███
█   █ █ █ █   █ █       █ █   █   █ █ █   █       █ █ █   █ █     █   █         █
███ █ ███ █ █████ ███ ███ █ █ ███ █████ █ █ █████ █████ ███ █ ███████ █████ ███ █
█ █ █   █ █   █ █   █ █ █ █ █   █   █   █ █     █     █ █ █ █   █             █ █
█ █████ █ █ ███ █ █ ███ █ █ █████████ ███ █ █ ███ █ █████ ███ ███ █ █████ █ █████
█   █ █       █   █   █   █ █ █ █   █ █     █ █   █           █ █ █     █ █   █ █
█ █ █ ███████ █ █████████ ███ █ █ █████ ███ █ ███████ █ █████ █ ███ █████████ █ █
█ █ █   █       █ █     █ █   █       █ █   █   █ █   █ █   █   █ █ █       █   █
█ █████ █ ███ ███ █ ███ █ ███ ███ ███ █ ███ █ ███ █ ███████ █ ███ ███ █████ █ █ █
█     █   █           █       █ █ █     █ █ █   █ █ █ █           █   █ █   █ █ █
█ ███████████████████ ███ █████ ███ █ ███ █ █ █ █ █ █ ███ █ ███ ███ █ █ ███ █ ███
█     █       █   █ █   █   █   █   █     █ █ █   █ █     █   █ █   █ █   █     █
█ ███████ █████ ███ █████ ███ ███ █ █ █████████ █████ █ ███ █ █ ███████ █ █████ █
█   █         █               █   █ █ █   █     █   █ █   █ █ █ █ █   █ █ █     █
█ █ ███ █ ███ █████████ ███████ █████████ █ ███ █ █████ ███ ███ █ █ █████ █ ███ █
█ █ █   █ █   █         █ █ █   █     █     █ █ █         █   █     █     █ █ █ █
███ █ █████ ███ ███ ███ █ █ █████ ███████████ █ ███ █████ █████████ █ ███ █ █ █ █
█   █   █ █     █     █         █     █   █       █ █ █     █   █ █ █   █     █ █
███ ███ █ █████ ███ ███ ███████ █████ █ █ █ █ █████ █ █████ █ █ █ ███ █ █████ █ █
█           █     █ █     █       █     █   █ █ █   █       █ █   █ █ █   █ █ █ █
█ █████ █ █████ █████ █████ █████████ █ ███ ███ █████ █████████ ███ █████ █ █████
█ █     █   █     █     █     █     █ █ █   █           █   █       █   █   █   █
█ █ ███ █████ █ █ ███████████ ███ ███████ ███████ ███ █ █ ███████ █ █ █ █████ ███
█ █ █       █ █ █   █       █     █ █         █   █   █   █     █ █   █ █       █
███████ █████ ███████████ █ █████ █ ███ █████ ███████ █████ ███████ █ ███ █ █████
█       █   █     █ █   █ █ █ █ █   █     █ █     █   █   █ █       █   █ █     █
█████ ███ █ █ █ █ █ █ █████ █ █ ███ ███ ███ █████████████ █ █████ █ ███████ █████
█ █   █   █   █ █ █                 █   █ █   █     █ █ █     █   █     █       █
█ █████ ███ ███ █████ █████████ █ ███ █ █ █ █████ █ █ █ ███ ███ ███ █ ███████ █ █
█     █ █     █     █ █   █     █     █   █       █   █   █     █   █ █ █     █ █
█ █ ███████ ███ █████ ███ ███ ███ ███ █ █ █ █████ ███████ █ ███ ███████ █ ███████
█ █       █   █     █ █   █   █ █ █   █ █   █       █         █ █     █   █     █
█ ███ █████████████ █████ █████ █ █████ ███ ███████████ ███████████ █████ █ ███ █
█ █       █   █     █ █   █ █     █     █   █   █     █   █ █   █   █     █   █ █
█ ███████ ███ ███ █ █ █ ███ ███ █ ███████████ █ ███ █████ █ █ █ █ ███ ███ ███ █ █
█   █     █     █ █   █     █   █ █       █ █ █ █   █         █         █     █ █
█████ ███ █ █ █ █████ ███ █████ █████ █████ █ ███ █ ███ █ █ ███████ ███ █ █████ █
█   █ █   █ █ █       █       █ █       █   █   █ █ █ █ █ █     █   █   █ █   █ █
███ █████ █ █ █████ █████████ █████ █ █████ █ ███ ███ █ ███████ █████ ███████ █ █
█ █ █ █ █   █ █       █       █ █ █ █     █ █     █   █     █       █ █ █       █
█ █ █ █ ███████ █ █ ███ █ █████ █ █ ███ ███ █████ █ █ ███ █ █████████ █ █████████
█         █     █ █     █ █   █       █           █ █ █ █ █ █ █ █   █           █
█████████ ███ █ █ █ █ ███ █ ███ █████████ █ ███ █ ███ █ ███ █ █ █ ███ ███ █████ █
█     █   █ █ █ █ █ █   █         █       █ █ █ █           █ █   █   █     █   █
█ ███████ █ █████ █████████ █ ███████████ ███ █ ███████ █ █ █ ███ ███ ███████ █ █
█ █     █   █   █   █       █     █     █   █ █   █     █ █ █             █ █ █ █
█ █ █ █ ███ ███ ███████ █ █████████ █████ ███ ███ ███████ █ ███████ █████ █ █████
█   █ █ █ █             █     █ █     █ █ █ █     █ █   █ █     █ █   █     █   █
███ ███ █ █████ █ ███████████ █ ███ ███ █ █ █ ███ █ █ █ ███ █████ █████████ █ ███
█   █     █ █   █   █             █ █ █   █   █       █ █       █     █       █ █
███ █████ █ ███ █████ █████ █ ███ █ █ █████ █ ███ ███████████ █ █ █ █████ ███ █ █
█       █       █ █       █ █   █     █ █   █ █     █ █     █ █ █ █   █   █ █   █
███████ ███ █████ █ █ █████████ ███████ ███ █████████ █████ ███ █ ███████ █ ███ █
█       █     █ █ █ █   █ █   █ █       █               █             █     █   █
███████ ███ ███ █ ███ █ █ ███ █████ █████ █ ███ ███ ███ █████ ███ ███ ███ █████ █
█       █     █       █ █                 █   █ █   █       █   █   █ █   █     E
█████████████████████████████████████████████████████████████████████████████████