█████████████████████████████████████████████████████████████████████████████████████████████████████
S     █     █ █         █     █     █   █ █   █         █           █ █     █     █ █   █ █ █ █     █
█ ███ █ ███ █ █ █ █████ ███ █ ███ █ █ █ █ █ █ █ █████ ███ █████ ███ █ █ ███████ █ █ ███ █ █ █ █████ █
█   █ █ █   █ █ █ █   █ █ █ █     █   █ █   █       █     █ █   █   █     █     █ █   █             █
█ █████ █ █ █ █ █████ █ █ ███ ███████ █ ███████ █████ █ ███ ███ ███ ███ █████ ███████ ███ █ ███ █ █ █
█ █   █ █ █ █     █         █ █       █ █     █ █     █ █ █   █   █   █   █ █     █       █ █   █ █ █
█ █ ███ ███ █ ███ ███ ███ ███████ █████ █████ ███ █ ███ █ █ █ ███ █ ███ ███ ███ █ ███ ███████████████
█       █ █     █   █ █   █   █ █     █   █     █ █   █   █ █   █ █             █ █   █ █   █     █ █
█ ███████ █████████ █ ███ █ █ █ ███ █ ███ █ ███ █ █ █ █ █ ███ █████████ ███ █████ █ █ █ █ █████ ███ █
█   █       █ █     █ █ █   █ █     █ █ █ █   █ █ █ █ █ █           █   █     █     █       █   █   █
█ ███ ███ ███ █ █ █████ █ █ █ ███ ███ █ █ ███ █ █████ █ ███ ███ █ █ █████ █ █ █ ███████ ███ ███ █ ███
█     █     █ █ █ █       █ █ █     █ █       █ █ █   █ █   █ █ █ █     █ █ █ █ █ █       █   █     █
█████ ███ ███ █ ███████ ███ █████████████████ █ █ ███████ █ █ ███ █ █████ █████ █ ███ ███████ █████ █
█       █   █ █ █     █ █     █       █       █ █   █ █   █     █ █ █   █   █ █     █ █         █   █
███ █ █████ █ ███ ███ ███████████████ █████ ███████ █ ███ █████ █████ █████ █ █████ ███ █ █████ █ █ █
█   █   █       █ █   █   █   █     █ █ █ █ █         █   █     █     █       █     █ █ █     █ █ █ █
█████ ███ █████ █████ █ █████ ███ ███ █ █ █ █ █ █ ███████████ ███ ███ █ █████ ███ ███ █ ███ ███████ █
█       █     █ █   █     █   █     █         █ █ █ █   █ █     █ █ █     █   █       █ █     █     █
███ █ ███████ ███ █ █ ███████ ███ █ █ ███████████ █ █ ███ ███ █ ███ █ ███ █ ███ ███ █████████ █ ███ █
█   █   █         █   █ █ █ █   █ █       █   █   █     █   █ █ █   █   █ █   █ █       █   █     █ █
█ █ █████ █ █ █████████ █ █ █ ███████ █ ███ ███ █ █████ █ ███ █████ ███████ █ █████ ███ █ █████ ███ █
█ █ █   █ █ █ █ █ █   █       █     █ █   █   █ █ █   █       █ █ █         █ █ █   █   █   █     █ █
███ ███ █ ███ █ █ █ █████ █ ███ █ █ █████ █ ███ █████ █ █ █ █ █ █ █ █ ███ █████ ███ █████ ███ █ ███ █
█     █ █ █       █ █     █ █   █ █   █       █         █ █ █ █     █   █ █ █     █     █   █ █ █   █
█ █ ███ █ ███ ███ █ █ █ █ ███ █ ███ █████ ███ ███ █████ ███ █ █████████ ███ ███ █████ █████ ███████ █
█ █   █ █ █     █     █ █     █ █ █   █     █   █   █     █ █ █       █   █       █   █   █       █ █
█ █ ███ █████ ███ █ █ ███████ ███ █████████████ █████████ █ █████ █ ███ ███ ███████████ █ █ █████████
█ █   █   █     █ █ █ █   █ █     █   █ █         █ █     █ █ █ █ █     █     █         █         █ █
█████ ███ █ ███ ███ ███ ███ █████ ███ █ ███ █████ █ █████ █ █ █ █ █ █ █ █ ███████ █ █████ █████ ███ █
█   █ █   █   █ █ █           █ █ █   █ █     █ █ █ █     █     █ █ █ █ █   █     █   █ █     █   █ █
█ █ █ █ ███ █ ███ ███████ █████ ███ ███ █████ █ ███ █ █ ███████████████ ███ ███ █████ █ █████ ███ █ █
█ █     █ █ █ █ █ █ █   █     █ █ █ █   █ █ █ █     █ █ █ █ █ █   █     █ █     █       █       █ █ █
█ █ ███ █ ███ █ █ █ ███ █ ███ █ █ █ █ ███ █ ███ █ ███ ███ █ █ █ ███ █████ █ █ █ █ ███ █████ █ █████ █
█ █ █       █           █   █   █ █   █   █   █ █ █ █   █     █           █ █ █ █ █ █   █   █ █   █ █
█████ █ ███████ █████ █ ███████ █ █ ███ █ █ ███ █ █ ███ █████ ███████ █████ ███████ █ █ █████ █ █ █ █
█ █ █ █   █   █ █   █ █   █ █   █ █ █   █     █ █         █   █ █   █ █ █ █         █ █ █     █ █   █
█ █ ███████ █ █ █ ███ █████ █████ █ █ ███ ███ ███████ ███████ █ █ ███ █ █ ███ █████ ███████ █ █████ █
█   █     █ █       █     █       █ █   █ █     █           █               █   █         █ █       █
█ █ ███ █ ███ █ █ ███ █████████ █ █ █████ ███ █████ █████████ █ █ █ █████ █████ █ ███████ █ █████████
█ █     █   █ █ █ █       █   █ █   █ █ █ █ █   █   █ █   █   █ █ █ █ █   █     █       █ █   █ █   █
█ ███ ███ █ █ ███████ █ █████ █ █████ █ █ █ ███████ █ ███ █ ███████ █ ███ █ █ ███ █ ███ █ █████ █ █ █
█ █ █ █ █ █ █ █ █   █ █   █   █     █ █   █         █ █       █   █   █ █   █ █ █ █   █ █ █   █   █ █
█ █ █ █ ███ █ █ ███ █████ █ ███ █████ ███ █ ███ █████ ███ █████ ███ ███ █ █████ █ █████████ ███ █ ███
█ █   █ █   █   █     █ █                 █ █ █ █   █ █ █       █     █ █       █ █   █   █   █ █   █
█████ █ █ █ █ ███████ █ ███ ███ █████████████ ███ ███ █ █ ███ █████████ █ █████████ █ █ █ █ ███████ █
█   █   █ █   █ █         █   █ █       █   █     █ █     █   █     █     █         █   █ █   █     █
███ █ ███ █████ █ █████ █████████ ███ █ █ █ ███ ███ █████ ███ █ ███ ███████ █ █████ █████████ █ █ █ █
█     █   █ █   █ █       █     █   █ █   █   █       █   █   █ █ █   █   █ █     █             █ █ █
█████ ███ █ █ ███████████ ███ ███ ███ ███████████ █████ █████████ ███ █ █████ █████ ███████ █ █████ █
█     █   █   █ █         █       █ █ █ █ █   █     █         █         █   █ █   █     █ █ █ █     █
█ ███ █ ███ ███ ███████ █ █ █████ █ █ █ █ █ █ ███ █████ █ ███ ███ ███ █████ ███ █ █ ███ █ ███████ █ █
█   █ █   █ █     █     █       █   █ █ █   █       █   █   █     █   █ █       █ █   █   █       █ █
███ ███ █ █ ███ ███████ █████ █████████ ███ ███ █ █ █ █ █████ ███ █████ █ █████ █████ █ █ █ ███ ███ █
█   █   █   █ █ █     █     █   █ █   █ █ █ █   █ █   █   █   █         █ █         █ █ █ █ █   █   █
███ █████ ███ █ █ ███████ █████ █ █ ███ █ ███████ █ █████ ███████ ███ ███ █ █ █████ █████ ███ █████ █
█   █       █ █   █ █     █   █     █   █         █ █ █ █   █       █     █ █ █       █ █   █     █ █
█ ███████ █ █ ███ █ █████ █ █████ █ █ █ █ ███████████ █ ███ ███████████████████ █████ █ █ ███ ███ █ █
█   █ █ █ █ █     █       █     █ █   █           █       █ █   █   █   █ █       █       █ █ █ █ █ █
█ ███ █ █ █ █████ ███ █████ █ ███████████ ███ █ █ █████ ███████ █ █ █ █ █ ███ █████ █ ███ █ ███ █████
█ █     █ █ █ █     █     █ █       █     █   █ █   █ █         █ █   █ █   █ █     █ █     █   █   █
███ █ ███ ███ █ █████ █ ███ █ ███ █ █████ ███ ███████ ███ █ ███████ ███ █ ███ █████ █████ █ █ ███ █ █
█   █   █   █     █   █     █ █ █ █   █ █ █     █     █ █ █   █   █ █ █   █   █   █     █ █     █ █ █
█████ ███ ███ ███████ █ █ ███ █ ███████ █ █████████ ███ ███ █ █ █ ███ █ ███ ███ ███ ███████████ ███ █
█         █ █         █ █   █     █       █   █     █ █ █ █ █ █ █     █   █     █   █     █ █ █   █ █
█ ███████ █ ███████ █ █ █ ███ ███████ █ █████ █████ █ █ █ ███ █████ ███ ███ █ ███████ ███ █ █ █ ███ █
█ █   █ █ █     █   █ █ █ █ █   █ █ █ █     █   █     █   █   █ █   █       █     █ █ █ █   █   █ █ █
███ ███ █ ███ ███ ███ █████ █ █ █ █ █████ ███ ███ █████ █ ███ █ █ █ █ █ █ █ █ ███ █ █ █ █ ███████ █ █
█     █     █ █     █       █ █   █     █           █   █       █ █   █ █ █ █ █   █     █     █ █   █
█████ █ █████ █████ ███ ███ █ ███████ ███ █████████ ███ ███ █ ███ █ █████ █████ █████ █ █ ███ █ █ █ █
█     █ █           █   █   █ █     █ █ █   █       █     █ █     █     █ █   █ █   █ █ █ █     █ █ █
█ █ ███ ███ ███ █████ █ █ █████ █ ███ █ █ █ ███ █████████ █████ █████ ███████ █████ ███████ ███ █ ███
█ █ █         █ █ █   █ █ █ █ █ █ █   █   █ █   █     █ █     █     █     █ █   █ █     █ █ █       █
█ ███████ ███ ███ █ ███ ███ █ ███ ███ ███ ███ █████ ███ █████ ███ ███ █ ███ █ ███ █ █████ ███ ███ █ █
█ █     █ █ █ █ █ █ █     █       █       █   █ █   █   █     █     █ █ █   █ █   █ █     █   █   █ █
█ █ ███ █ █ ███ █ █ ███████████ █████████ █████ █ ███ ███ █ ███ █ ███ █ ███ █ ███ █ █ █ █████████ ███
█   █ █ █ █   █                 █       █   █ █   █ █ █ █ █   █ █   █ █   █       █   █ █ █   █     █
█████ █ █ ███ █████████ █ ███████ █ █ ███ ███ ███ █ █ █ ███ ███ ███ ███ █ ███ █ █ ███ █ █ █ █ █ ███ █
█         █ █       █ █ █ █ █     █ █     █       █     █     █   █ █ █ █   █ █ █     █   █ █   █   █
█ █ █████ █ █ █████ █ █ ███ █ █ █████ █████████ ███████ █ ███ █ █████ █████ █ █████ ███ ███ ███████ █
█ █ █   █ █ █   █ █   █     █ █   █   █   █ █   █     █ █ █   █         █       █ █ █   █   █       █
███ ███ ███ ███ █ █ █████ █ █████ ███ ███ █ █ █ ███ █ █ █████ █ ███████ ███████ █ █████████████ █ ███
█   █   █ █ █ █ █ █   █   █ █     █ █ █       █   █ █ █   █   █ █     █ █   █     █ █       █ █ █   █
█ █████ █ █ █ █ █ ███ █ ███ ███████ █ █████ █ █ ███ █ ███ █ █████ ███ █ █ █████ ███ █ ███ ███ █ ███ █
█ █       █   █   █   █ █   █   █ █   █ █   █ █ █ █ █ █       █     █ █ █   █     █   █     █ █ █   █
█ █ ███ ███ █ █████ ███ █████ ███ ███ █ ███ █ █ █ █ ███ ███████ █████ █ ███ █ ███ █ ███ █████ █████ █
█     █ █ █ █   █       █   █ █   █ █     █ █ █ █         █ █ █ █       █ █   █     █ █ █           █
█ ███████ █████ ███ █ █ █ ███ ███ █ █ ███ █ █████ █ █████ █ █ █ █████████ █████████ █ ███████ █████ █
█     █ █       █   █ █         █       █ █   █ █ █   █ █     █ █     █ █                       █   █
███ ███ ███ ███████ ███ █████ ███ █████ ███ █ █ █ █████ █ █████ █ █████ ███████████ ███████ █ ███ █ █
█   █   █ █ █ █   █ █   █       █ █ █     █ █     █         █       █       █     █     █   █ █   █ █
███████ █ █ █ ███ ███████ █████ ███ ███ █ █ █ █ ███ ███████████ ███ ███████ █ ███ █ ███ █ █ ███ ███ █
█ █     █   █         █   █   █   █ █ █ █ █ █ █ █ █       █       █ █       █   █ █   █ █ █   █   █ █
█ █ █ ███ ███ █ ███████ ███ █ █ █ █ █ █████████ █ ███ ███████ ███ █ █████ █ █████ █ ███ ███ ███ █ ███
█   █       █ █       █   █ █ █ █   █   █   █ █   █ █ █ █   █   █ █ █     █ █   █ █   █ █     █ █   █
█ ███ █ ███ █ █ ███ █ █ ███ ███████████ █ ███ █ █ █ █ █ █ ███ █ █████████ █████ █ █ █ ███ ███████ ███
█ █ █ █   █   █ █   █ █ █ █                 █   █ █       █   █                 █   █ █   █ █ █ █ █ █
█ █ ███ ███ ███ ███ █ █ █ █ █ █████ ███████ █████████ ███ █████ █ █████ ███ ███████ ███████ █ █ █ █ █
█   █     █   █   █ █ █   █ █   █     █ █ █       █ █ █ █ █     █ █       █   █       █     █ █   █ █
█ █ █ █████████ █ ███ ███ █ █ █████ █ █ █ █████ █ █ ███ █ █████ █████████ █ █████ █ █ █ █ ███ █ ███ █
█ █ █ █         █ █       █ █     █ █ █         █             █     █     █ █     █ █   █     █     E
█████████████████████████████████████████████████████████████████████████████████████████████████████