█████████████████████████████████████████████████████████████
S     █         █         █ █         █       █       █     █
█ █ █ ███████ █ ███ █ ███ █ █████ ███ █████ █ █████ ███████ █
█ █ █   █     █ █ █ █   █ █         █       █         █     █
███ █ █ █ █ █ ███ ███ █████ ███ █ █████ █████ █ █████████ ███
█ █ █ █   █ █   █       █ █ █   █   █   █   █ █             █
█ ███████ █ █ █████████ █ █ █ █ ███ █████ ███ █ █ █ █ █ █ ███
█   █   █ █ █   █           █ █ █ █ █         █ █ █ █ █ █   █
███ █ █ ███ █████ ███ █████████ █ █ ███ █ █████ █ ███ ███ ███
█   █ █   █     █ █ █   █ █       █   █ █   █   █ █ █ █ █   █
█ ███ █████ █ █████ █ ███ █ ███████ █████ ███ █ █ █ ███ █ █ █
█ █   █     █   █         █ █     █ █     █ █ █ █ █   █   █ █
█ █ █ █ █ ███ █ ███ ███████ ███ █ █████████ ███████ █████████
█ █ █ █ █ █   █ █       █ █ █ █ █     █   █   █ █       █ █ █
█ █ ███ █ ███████ ███████ █ █ ███████ ███ █ █ █ █ ███ ███ █ █
█ █ █ █ █       █ █     █     █       █ █   █     █ █   █   █
█ █ █ ███ ███ █ █ █ ███ ███████ ███ █ █ █ █████ ███ ███ █ ███
█   █       █ █     █ █ █ █ █ █ █   █   █   █ █ █           █
█ █ █ ███████████████ █ █ █ █ █ ███ █ ███ █ █ ███ █ ███ █ █ █
█ █     █     █         █     █   █ █   █ █   █   █ █ █ █ █ █
█ █ █████████ ███ ███ █ █ █ ███████ █ ███████ █████ █ █ █████
█ █ █   █         █   █   █     █   █ █   █ █     █   █     █
█ ███ █ ███ ███ ███ █████ █ ███ █ █ █ █ █ █ ███ █ █ ███ █ █ █
█     █ █ █   █ █       █ █ █   █ █ █ █ █ █   █ █ █ █ █ █ █ █
█ █ ███ █ █ ███████ █████ ███████ █ █ █ ███ ███ ███ █ █ ███ █
█ █ █   █ █ █   █   █   █ █   █ █ █ █           █   █ █ █ █ █
█████ ███ █████ ███ ███ ███ ███ █ █████ █████████ ███ █ █ █ █
█ █   █     █   █ █ █           █ █ █ █ █       █ █   █ █   █
█ ███ █ █████ ███ █ ███ ███ █ ███ █ █ █████████ █████ █ ███ █
█   █ █       █ █ █ █     █ █ █     █   █ █   █     █   █   █
███ █ █████ █ █ █ █████ █ ███████ █ █ ███ █ █ █ █ █ █ █ █████
█ █ █   █ █ █           █ █ █ █   █ █     █ █   █ █   █ █ █ █
█ █ █ ███ █████ █████ █████ █ ███ █ ███ ███ ███ █████████ █ █
█     █   █     █   █ █     █   █ █   █ █     █ █   █ █   █ █
█████ █ █ █ ███ █ █ █ █████ █ █ █████ █ ███ █████ ███ █ █ █ █
█     █ █   █   █ █ █ █ █     █         █     █ █   █   █   █
███ █ ███████ █████ ███ ███████████ █ █████ ███ █ █ █ ███ █ █
█   █             █                 █ █ █       █ █     █ █ █
█ █████ █ ███████ █ ███ ███████████ ███ █ ███ █████ █████ ███
█ █   █ █ █   █     █   █   █ █ █ █ █ █     █       █ █ █   █
█ █ █ ███ ███ ███ ███ █████ █ █ █ ███ ███ █ █████████ █ █ █ █
█   █   █ █       █     █ █   █     █   █ █ █           █ █ █
█████ █ ███ ███ ███ █████ ███ █ █ ███ █ ███ █ ███ █ ███████ █
█     █ █     █   █     █       █ █   █   █   █   █       █ █
█████ ███ █ █ █ █ ███ █████ █████ ███ █ ███████ █████ █████ █
█       █ █ █ █ █ █           █ █   █ █ █ █   █     █   █ █ █
█ █ █ ███████ ███████ █ █ ███ █ ███ █ █ █ █ ███ ███████ █ █ █
█ █ █ █   █   █     █ █ █   █   █ █   █     █ █   █   █   █ █
███████ █ █ ███ █████ █████ ███ █ █ █ █████ █ █████ ███ █ ███
█ █   █ █ █       █     █   █ █   █ █   █   █ █ █     █ █ █ █
█ █ ███ █ ███ █████████ █████ ███ █ █████ █ █ █ █ █ ███ ███ █
█     █ █   █ █         █     █ █ █     █ █   █   █         █
█ █ ███ █ ███ ███ ███ █ █ █████ ███ ███ █ █ ███ █ █ █ ███████
█ █   █ █ █   █   █ █ █   █ █         █ █ █   █ █ █ █ █   █ █
█ ███ █ █████ █ █ █ ███ █ █ ███████ █ █████ ███████ █ ███ █ █
█ █     █     █ █ █     █ █ █ █ █   █ █ █ █ █ █ █   █       █
█████ █ █ ███ █████ ███████ █ █ ███ ███ █ ███ █ █ █████████ █
█     █   █ █ █ █       █     █           █   █         █   █
█ █████ ███ █ █ █ ███ ███ █ █████ █ ███ ███ █ █████ █████ ███
█   █     █     █   █ █   █       █   █   █ █       █       E
█████████████████████████████████████████████████████████████