#################################################################################
S           #       #   #     #         #     #   # #   #             #         #
### # ##### ####### # # # # ### ### ####### # # ### # # # # # # ########### # ###
# # # # # # #     # # #   #   # #           #   #     # # # # # # #     #   #   #
# ### # # ### # # # ### ##### ### # # # # ### # ####### # ### ### ### # ##### ###
#   #         # #   # #     #     # # # # #   # #       # # #     #   # #     # #
# ####### # ### ##### ### ######### # # # ### # ### ### ### # # ### ### # # ### #
#     #   #   # # #   #   #     #   # # # # # # #     #     # # #   #   # # #   #
# ##### ### ### # # ####### ### ### ### # # # ####### ##### # ##### ### # ### ###
#   # #   #   # #   #     #   # #   #   # # #   # #     #           #   #     # #
# ### # ####### # ##### # # ### ####### # # ##### ### # ########### ######### # #
#     # #     #   # #   # #   # #       # #   # # # # #   # # # #     # #   #   #
# ### # ##### # ### # ##### ####### ####### # # # # ### # # # # # # ### # # ### #
# #   # #     #             # # # # #   #   # #     # # #     #   #       #     #
# # ##### # # ####### ### # # # # # ### ##### # # ### # ### # # # # ####### ### #
# #   # # # #         #   #     # # #     # #   #   #     # # # # # # #       # #
### ### ### # # ########### ##### # # ##### # ### # # # # ##### # ### ### #######
#   #   #   # #     #     # #   #       #     # # # # # # # #   # #   #     #   #
### # ### ### ### ##### ##### # ### ##### ### # # ##### ### ####### ##### ### ###
#           # # #     #   #   #   #         #   # #             #   #       # # #
# ##### ### ### # ##### ### ### ####### # # ####### ### ### ### ### # # # ### # #
#   #     # # #               #       # # # #     # # #   # #       # # #   #   #
### ####### # ####### # # # # ### # # ### ##### ### # ################### # # ###
#   #     #   #       # # # #   # # #   #   #   #           #       #     # #   #
### # # ####### # ######### ### ### # ### ### ### # # ### # # ######### ##### ###
#   # # # #   # #       # #   #   # # #   #       # # #   # #     #   #         #
### # ### # ##### ### ### # # ### ##### # # ##### ##### ### # ####### ##### ### #
# # #   # #   # #   # # # # #   #   #   # #     #     # # # #   #             # #
# ##### # # ### # # ### # # ######### ### # # ### # ##### ### ### # ##### # #####
#   # #       #   #   #   # # # #   # #     # #   #           # # #     # #   # #
# # # ####### # ######### ### # # ##### ### # ####### # ##### # ### ######### # #
# # #   #       # #     # #   #       # #   #   # #   # #   #   # # #       #   #
# ##### # ### ### # ### # ### ### ### # ### # ### # ####### # ### ### ##### # # #
#     #   #           #       # # #     # # #   # # # #           #   # #   # # #
# ################### ### ##### ### # ### # # # # # # ### # ### ### # # ### # ###
#     #       #   # #   #   #   #   #     # # #   # #     #   # #   # #   #     #
# ####### ##### ### ##### ### ### # # ######### ##### # ### # # ####### # ##### #
#   #         #               #   # # #   #     #   # #   # # # # #   # # #     #
# # ### # ### ######### ####### ######### # ### # ##### ### ### # # ##### # ### #
# # #   # #   #         # # #   #     #     # # #         #   #     #     # # # #
### # ##### ### ### ### # # ##### ########### # ### ##### ######### # ### # # # #
#   #   # #     #     #         #     #   #       # # #     #   # # #   #     # #
### ### # ##### ### ### ####### ##### # # # # ##### # ##### # # # ### # ##### # #
#           #     # #     #       #     #   # # #   #       # #   # # #   # # # #
# ##### # ##### ##### ##### ######### # ### ### ##### ######### ### ##### # #####
# #     #   #     #     #     #     # # #   #           #   #       #   #   #   #
# # ### ##### # # ########### ### ####### ####### ### # # ####### # # # ##### ###
# # #       # # #   #       #     # #         #   #   #   #     # #   # #       #
####### ##### ########### # ##### # ### ##### ####### ##### ####### # ### # #####
#       #   #     # #   # # # # #   #     # #     #   #   # #       #   # #     #
##### ### # # # # # # ##### # # ### ### ### ############# # ##### # ####### #####
# #   #   #   # # #                 #   # #   #     # # #     #   #     #       #
# ##### ### ### ##### ######### # ### # # # ##### # # # ### ### ### # ####### # #
#     # #     #     # #   #     #     #   #       #   #   #     #   # # #     # #
# # ####### ### ##### ### ### ### ### # # # ##### ####### # ### ####### # #######
# #       #   #     # #   #   # # #   # #   #       #         # #     #   #     #
# ### ############# ##### ##### # ##### ### ########### ########### ##### # ### #
# #       #   #     # #   # #     #     #   #   #     #   # #   #   #     #   # #
# ####### ### ### # # # ### ### # ########### # ### ##### # # # # ### ### ### # #
#   #     #     # #   #     #   # #       # # # #   #         #         #     # #
##### ### # # # ##### ### ##### ##### ##### # ### # ### # # ####### ### # ##### #
#   # #   # # #       #       # #       #   #   # # # # # #     #   #   # #   # #
### ##### # # ##### ######### ##### # ##### # ### ### # ####### ##### ####### # #
# # # # #   # #       #       # # # #     # #     #   #     #       # # #       #
# # # # ####### # # ### # ##### # # ### ### ##### # # ### # ######### # #########
#         #     # #     # #   #       #           # # # # # # # #   #           #
######### ### # # # # ### # ### ######### # ### # ### # ### # # # ### ### ##### #
#     #   # # # # # #   #         #       # # # #           # #   #   #     #   #
# ####### # ##### ######### # ########### ### # ####### # # # ### ### ####### # #
# #     #   #   #   #       #     #     #   # #   #     # # #             # # # #
# # # # ### ### ####### # ######### ##### ### ### ####### # ####### ##### # #####
#   # # # #             #     # #     # # # #     # #   # #     # #   #     #   #
### ### # ##### # ########### # ### ### # # # ### # # # ### ##### ######### # ###
#   #     # #   #   #             # # #   #   #       # #       #     #       # #
### ##### # ### ##### ##### # ### # # ##### # ### ########### # # # ##### ### # #
#       #       # #       # #   #     # #   # #     # #     # # # #   #   # #   #
####### ### ##### # # ######### ####### ### ######### ##### ### # ####### # ### #
#       #     # # # #   # #   # #       #               #             #     #   #
####### ### ### # ### # # ### ##### ##### # ### ### ### ##### ### ### ### ##### #
#       #     #       # #                 #   # #   #       #   #   # #   #     E
#################################################################################